###############~
#............~~~
A.**********.~~B
#**..........~~~
##**....****~~~~
##*..****.$~~~~~
###.....*.~~~~~~
~~~~~~~~~~~~~~~~
~~~~~~~~~~~~~~~~
